despite - pomimo
in order to - w celu, aby, ¿eby
resolved - zdecydowany
meant to be - mialo byc
fork - rozdwajaæ siê
stuff - rzeczy, materia³, coœ
implicitely - niejawnie
manifest - oczywisty
delpoy - rozmiescic, rozwijac
explicitly - wyraznie
snippet - skrawek
qualified - wykwalifikowany, kompetentny
furthermore - ponadto, dodatkowo
would know - wiedzialby
merge - laczyc, scalac
merged - scalone
following - nastepujacy, kolejny
against - przeciwko, przed
as well - takze
revised - ulepszony
thus - tak wiec, a zatem
applied - stosowany
encourage - zachecac, popierac, namawiac
circumstances - okolicznosci, warunki
to assist in ensuring - pomóc w zapewnieniu
ommited - pominiety
entirely - zupelnie, calkowicie
deprecated - przestarzale
difficulty - trudnosc
transitive - przechodni, posredni
gathered - zebrane
gather - zbierac, gromadzic
exclude - wykluczac
affect - wplynac, oddzialywac
look up - sprawdzac
steep - stromy
upon - na, na podstawie
tweak - sciagac, uszczypnac
to match - dopasowac
along with - oraz
distributed - rozprowadzane
truncated - obciety
as a whole - jako calosc
distinguished from - odroznic od
responsive - czu³y, wra¿liwy
rendering - wykonanie, odtwarzanie
usability - uzytecznosc
prime concern - glownym problemem
incostintency - niezgodnosc, sprzecznosc
nightmarish - koszmarny
round of - runda
hallmark - pietno, odznaka
hallmark of - cecha charakterystyczna
so forth  - itd
disrupt - zaklocac
disrupting - zaklocajacymi
one approach - jedno podejscie
reflect - odzwierciedlic
appeased - uspokojony, zaspokojony
bundle - zapakowac
bundled - w zestawie
come - przyjsc
take a close look - przyjrzec sie blizej
surpass - przewyzszac
act upon - dzialac na
accordingly - odpowiednio
Taken together - razem wziete
altered - zmieniony
alter - zmieniac, modyfikowac
approach - podejscie
covered - pokryty, ukryty
distinct - odrebny
nearly - prawie
dispersed - rozproszone
remain - pozostawac, zostac, trwac
consistent - zgodny, konsekwentny
bargain - okazja
tucked - schowany
tuck - podwinac, schowac
devoted to - poswiecony czemus
bundle - pakiet
purposes - cele
























